It's|It is
become|turn out to be|grow to be|turn into
first|1st|very first
the most|probably the most|essentially the most|one of the most
children|kids|youngsters
small|little|tiny
Having|Getting
all the|all of the
more|much more|a lot more|far more
Tv|Television
is not|isn't|just isn't
famous|well-known|renowned
exactly|precisely|specifically
where|exactly where
maybe|perhaps|possibly
during the|throughout the|through the
it is|it's
a new|a brand new
within the|inside the
that is|that's|which is
in fact|in actuality|in reality
those who|those that|those people who|those people that
quickly|rapidly|swiftly|speedily|fastly
easier|simpler|less difficult|less complicated
basic|fundamental|simple|standard
occur|happen
understand|comprehend|realize|recognize
situation|scenario|circumstance
However|Nevertheless|Nonetheless|Even so
still|nonetheless
a good|a great|an excellent|a superb
nicely|properly
though|although
ways|methods|techniques|approaches
almost|nearly|just about
virtually|practically
they are|they're
trying to|attempting to
fact|reality|truth
does not|doesn't
while|whilst|although|even though
would be|could be
There is|There's|There is certainly
multiple|numerous|several|many
found|discovered|located|identified
everything|every thing|every little thing|almost everything
importance|significance
imagine|envision
each|every|each and every
depends on|depends upon
you are|you're|you might be|you will be
in your|inside your|within your
explore|discover
fully|totally|completely
don't|do not
have to|need to
at the|in the
end|finish
Ideas|Suggestions|Concepts|Tips
to make|to create
extra|additional|added
money|cash|funds|dollars
home|the house|the residence|the property
require|need|call for|demand
easy|simple|straightforward|effortless
to get|to obtain
started|began
you can|you are able to|you'll be able to|it is possible to
tough|difficult
good|great|excellent|very good|amazing
most people|many people|a lot of people
learn|understand|discover|find out
people|individuals|folks|men and women
every|each and every|each|every single
There is a|There's a
opportunity|chance
and the|and also the|as well as the|along with the
costs|expenses
and a|along with a|as well as a|plus a
price|cost
challenging|difficult
finding|discovering|locating|obtaining
the right|the proper|the correct|the best
to start|to begin
unwanted|undesirable
you have|you've|you've got|you might have
you will|you'll|you may
feel|really feel
whole|entire
Once you|When you
visit|go to|pay a visit to|check out|look at
Eventually|Ultimately
you will|you'll|you may|you are going to
be able to|have the ability to
product|item
both|each
convenient|handy
Popular|Well-liked|Well-known|Common
include|consist of|contain|incorporate
a number of|numerous|several|quite a few
to help|to assist
Making|Creating|Generating|Producing
If you|In the event you|Should you|In case you
enjoy|appreciate|take pleasure in|get pleasure from
things|issues|points|happenings
start|begin|commence|start off
business|company|enterprise|organization
businesses|companies|organizations
can be|may be|could be|might be
reliable|dependable
industry|business|market
big|large|huge|massive
potential|possible|prospective
Not only|Not just|Not merely|Not simply
but it|however it
truly|actually|genuinely|sincerely
You need|You'll need|You will need
create|produce|generate|develop
Doing|Performing
research|analysis|study|investigation
cost|price|expense
effectively|successfully|efficiently
ability|capability|capacity
unique|distinctive|special|exclusive
help you|assist you to|enable you to|allow you to
Another|An additional|Yet another|One more
option|choice|alternative|selection
purchase|buy|obtain|acquire
with your|together with your|along with your
Learning|Studying|Understanding
how to|how you can|the best way to|the way to
difficult|challenging|tough|hard
process|procedure|method|approach
type|kind|sort
you want to|you need to|you would like to
fun|enjoyable
your own|your very own
experienced|skilled
produce|create|generate
less|much less
kind of|type of|sort of
Are you|Are you currently
Depending on|Based on
dependable|reliable
average|typical
according to|based on|in accordance with
increasing|growing
Requirements|Specifications|Needs
keep|maintain
under|below
that are|which are
many|numerous|several|a lot of
reasons|factors
you need to|you should|you have to|you'll want to
hire|employ
professional|expert|skilled
system|method|program|technique
house|home|residence
because|simply because|since|due to the fact
problems|issues|difficulties|troubles
cases|instances|circumstances|situations
before|prior to|just before|ahead of
The problem|The issue
that you|which you|that you simply
need|require|want|need to have
you think|you believe|you feel
they think|they believe|they feel
should|ought|really should|need
done|carried out|completed|accomplished
when you|whenever you|once you|if you
article|write-up|post
will be|will probably be|will likely be|is going to be
to understand|to know
about the|concerning the
minimize|reduce|decrease
Getting|Obtaining|Acquiring|Finding
Hard|Difficult|Tough|Challenging
benefits|advantages|rewards|positive aspects
often|frequently|usually|typically
Perhaps|Maybe|Possibly
areas|locations|places
used|utilized|employed|utilised
are not|aren't|usually are not
aware|conscious
regular|normal|standard|typical
daily|every day|day-to-day|everyday
to consider|to think about
Energy|Power
a lot of|lots of|plenty of|a great deal of
due to|because of|as a result of|on account of
design|style
something|some thing|one thing
family|family members|loved ones|household
purchased|bought
absolutely|completely|totally|definitely
love|adore|enjoy|really like
Advantages|Benefits|Positive aspects
Office|Workplace
Whether|Whether or not|Regardless of whether|No matter whether
you're|you are
when it comes to|with regards to|in terms of|in relation to
a few|a couple of|several|some
different|various|distinct|diverse
options|choices|alternatives|possibilities
common|typical|widespread|frequent
types|kinds|sorts|varieties
Protect|Safeguard|Shield|Defend
Maintenance|Upkeep
that can|that may|that will|that could
harmful|dangerous
throughout|all through
health|well being|wellness
without|with out|with no
knowing|understanding|realizing
serious|severe|significant|critical
caused|brought on|triggered
Reducing|Decreasing|Lowering
large|big|huge|significant
looking to|seeking to|trying to
solution|answer|remedy|resolution
tips|suggestions|ideas|guidelines
major|main|significant|key
happens|occurs|takes place
happen|occur|take place
a great|an excellent|a fantastic|a terrific
damage|harm
much|a lot|significantly|considerably
as well|also|too|at the same time
Dealing with|Coping with
always|usually|often|constantly
up to|as much as
deal with|cope with|handle
expenses|costs
doesn't|does not
aren't|are not
could be|might be|could possibly be
ensure|make sure|guarantee|make certain
ideal|perfect
expensive|costly|pricey|high-priced
Handle|Deal with|Manage
essential|important|crucial|vital
homes|houses|properties
entire|whole
treatment|therapy
accomplished|achieved
you've|you have
you might|you may
better|much better|far better|greater
to use|to make use of|to utilize
using|utilizing|making use of|employing
tell you|let you know
today|these days|nowadays|right now
searching|looking
you know|you realize
area|region|location
next|subsequent
probably|most likely|possibly|almost certainly
important|essential|crucial|critical
There's|There is
market|marketplace|industry
remember|keep in mind|bear in mind|don't forget
sure|certain|positive|confident
and even|as well as
online|on-line|on the internet|on the web
since|because|given that|considering that
the internet|the web|the net|the world wide web
massive|huge
some people|many people
idea|concept|thought|notion
their own|their very own
that's|that is
real|actual|genuine
healthy|wholesome
There are plenty of|There are many
financial|monetary|economic
offers|provides|delivers|gives
Marketing|Advertising|Marketing and advertising|Advertising and marketing
This is|This really is
generate|create|produce
results|outcomes
and then|after which
goals|objectives
who have|who've
isn't|is not
completely|totally|entirely|fully
way to|method to|approach to|technique to
Information|Info
Products|Goods|Items|Merchandise
extremely|incredibly|unbelievably
creating|making|developing|producing
info|information
through|via|by means of|by way of
pretty|fairly
topic|subject
again|once more|once again
several|a number of|numerous|many
considering|thinking about|contemplating|taking into consideration
a variety of|a number of|many different
Internet|Web|World Wide Web|Net
focus|concentrate
working|operating
means|indicates
running|operating
plan|strategy|program
you want|you would like|you need|you desire
many people|many individuals|lots of people|a lot of people
tend to|have a tendency to|often
people|individuals
unwritten|unspoken-of
similar to|something like|a bit like
pictures|photos|pics
picture|photo|pic
terrible|horrible|really bad
third|3rd
fourth|4th
fifth|5th
considering|pondering on|thinking about
in general|at all|for the most part
unfortunately|sadly
fortunately|happily
some reason|whatever reason
autocorrect|auto-correct|text-correction|automatic text correction
chumps|losers|idiots|fools
chump|loser|idiot|fool
funny|hilarious|hysterical
technological device|piece of technology
smartphone|smart phone|superphone|super phone
mysterious|unexplainable|weird|strange
cane|walking stick
brave|courageous|fearless|fierce
father|dad
die|pass away
died|passed away
fire|flames|blaze
ghostly|paranormal|unnatural
immediatiately|instantly|right away
beckon|lure
your secret|what you're hiding
guide|instructions
oddly|strangely|weirdly
nothing|not a thing|not one thing
calm|relax|settle|ease
just by|simply by
one|1
two|2
three|3
four|4
five|5
six|6
seven|7
eight|8
nine|9
nemesis|enemy

